1111111111
1P0C000CE1
1111111111