1111111
10C0001
100P001
1000E01
1111111