111111111111111111111111111111
10010000000000C000111111110011
100001111100000000000000110011
1P0011000000111100101100000001
100000100000000000100000000011
100011111000000000000110011101
100011100000111000100000000011
100001111100000000100001111101
111110000000000000000010000001
100000000001111100100000100001
10E011111000000001100001100001
1000111110000C0000111110000001
1000111110000000001111100C0001
1000111110000C0000111110000001
111111111111111111111111111111