1111111111111111111
10000000000000C0001
1000011111000000001
1P00110000000000001
1111111111000011111
1000000000000000001
1000111110000000011
10E0111110000C00001
1111111111111111111