111111111111111111111111111111
10010000000000C000111111110011
100001111100000000000000110011
1P0011000000000000101100000001
100000000000000000100000000011
100011111000000000000110011101
1000111000000C0000100000000011
100001111100000000100001111101
100110000000000000000010000001
100000000000000000100001100001
10E01111100000B001100001100001
111111111111111111111111111111